..................#############........
..................#...........#........
..................#...........#........
..................#...........#........
..................#...........#........
..................#...........#........
..................#...........#........
..................#...........#........
..............#####...........#........
..............#...............#........
..............#...........#####........
..............#...........#............
......###########.........#............
......#.......#.#.........#............
......#.......#.#.........#............
......#.......#.#.........#............
......#.....#####.........#............
......#.....#.#...........#............
......#.....#.########^...#########....
......#.....#.........#...........#....
......#.....#.........#...........#....
......#.....#.........#...........#....
......#.....#.........#...........#....
......#.....#.........#...........#....
......#########.....###########...#....
............#.#.....#.#.......#...#....
............###########.....###########
..............#.....#.......#.#...#...#
..............#.....#.......#.#####...#
..............#.....#.......#.........#
#####.........#.....#.......#.........#
#...#.........#.....#.......#..........
#...#.......###########.....#..........
#...#.......#.#.....#.#.....#..........
#...###########.....#########..........
#...........#.........#................
#...........#.........#................
#...........#.........#................
#...........#.........#................
#...........#.........#................
#############.........#................
......................#................
..................^####................

R,4,L,10,L,10,
L,8,R,12,R,10,R,4,
R,4,L,10,L,10,
L,8,R,12,R,10,R,4,
R,4,L,10,L,10,
L,8,L,8,R,10,R,4,
L,8,R,12,R,10,R,4,
L,8,L,8,R,10,R,4,
R,4,L,10,L,10,
L,8,L,8,R,10,R,4